wwwwwwwwwwwwwwwwwwwwwwwwww
w---A----------w---------w
w--------------w---------w
w--------------w---------w
w------------------------w
w------------------------w
w---c---wwwwwwww---------w
w------------------------w
w------------------------w
w-------w----------------w
w-------w----------------w
w-----e-w------------e---w
wwwwwwwwwwwwwwwwwwwwwwwwww
