wwwwwwwwwwwwwwwwwwwwwwwwww
w---------A--------------w
w------------------------w
w------------------------w
w------------------------w
wwwwwwww-wwwwwwwwwwwwwwwww
w------------------------w
w------------------------w
w------------------------w
w------------------------w
w------------------------w
w----------e-------------w
wwwwwwwwwwwwwwwwwwwwwwwwww