wwwwwwwwwwwwwwwwwwwwwwwwww
w--------------w---A-----w
w--------------w---------w
w--------------w---------w
w--------------w---------w
w--------------w---c-----w
w-------wwwwwwwwwwwwwwwwww
wwwwwwww-----------------w
w------------------------w
w------------------------w
w-------w----------------w
w-----e-w------------e---w
wwwwwwwwwwwwwwwwwwwwwwwwww
