wwwwwwwwwwwwwwwwwwwwwwwwww
w---------Ax-------------w
w---------x--------------w
w---------x--------------w
w---------x--------------w
w---------x--------------w
w---------x--------------w
w---------x--------------w
we--------x--------------w
w--------------------x---w
w------------------------w
wx-----------------------w
wwwwwwwwwwwwwwwwwwwwwwwwww
