wwwwwwwwwwwwwwwwwwwwwwwwww
w---A--------------------w
w------------------------w
w--------------w---------w
w--------------w---------w
w--c-----------w--c------w
w-------wwwwwwww---------w
w------------------------w
w--w-------------wwww----w
w---------------w--------w
w-------w-------w--------w
w-----e-w-------w----e---w
wwwwwwwwwwwwwwwwwwwwwwwwww
