wwwwwwwwwwwwwwwwwwwwwwwwww
w-------w--A-------------w
w------------------w-x---w
wwwwwwwwwwwwww-----www---w
w------------------------w
w----wwwwwwwww-----x-----w
w----w-------------------w
w----wwwwwwwwww----------w
w-x-----------w----------w
w----------x--w---x----x-w
w------c------wxw--------w
wx---------e--wxw----x---w
wwwwwwwwwwwwwwwwwwwwwwwwww