wwwwwwwwwwwwwwwwwwwwwwwwww
w---------wwx------------w
w---A-------ww----x------w
w-------------wwxww-ww---w
w------------ww-x--------w
w--x----------w--w-www---w
w--------------------x---w
w------------w-------w---w
w------------w----wwwwx--w
w------------w-------w---w
wx----x--------------x---w
wc-----------e--x--------w
wwwwwwwwwwwwwwwwwwwwwwwwww
