wwwwwwwwwwwwwwwwwwwwwwwww
w-----------A-----------w
w-wwwwwwwwwwwwwwwwwwwww-w
w-----------------------w
w-----------------------w
w-----------------------w
w-----------------------w
w-----------------------w
w-----------------------w
w-----------------------w
w-----------e-----------w
w-----------------------w
wwwwwwwwwwwwwwwwwwwwwwwww
