wwwwwwwwwwwwwwwwwwwwwwwwww
w-------w-A---w----------w
w-------w-----w----------w
w-------------------wwwwww
wwww---------------------w
w-----------w------------w
w-----------w-------c----w
w---------www------------w
wwww---------------------w
w-------------------wwwwww
wc------w-e---w----------w
w-------w-----w----------w
wwwwwwwwwwwwwwwwwwwwwwwwww
