wwwwwwwwwwwwwwwwwwwwwwwwww
w---------A--------------w
w------------------------w
w----wwwww-wwwwwwww-wwwwww
w--------w-w------w-w----w
w--------w-w--w--ww-w----w
w--------w-w--w-----w----w
w------w-w-w--wwwwwww----w
w---w--w-w-w-------------w
w---w--www-w-------------w
w---wwwwwwww-------------w
w--------------------e---w
wwwwwwwwwwwwwwwwwwwwwwwwww