wwwwwwwwwwwwwwwwwwwwwwwwww
w-----------A--------w
w---c----------------w
w--------------------w
w----w----w----------w
w----w----w----------w
w-----wwwww----------w
w--------------------w
w---------w----------w
w----w-----------c---w
w---------wwwwwwwww--w
w---------e----------w
wwwwwwwwwwwwwwwwwwwwwwwwww
